11111111111111111111111111111111111111111111111111111111111111111111111111111111
1                                                                              1
1 222222 22222 22222 2222222222 2222222  2222222 2222222222 22222 22222 222272 1
1 2                                                                          2 1
1 2                                                                          2 1
1 2  22222222 22222222  22222222   2222222222   22222222  22222222 22222222  2 1
1 2  2                                                                    2  2 1
1 2  2    33333  33333                                    33333  33333    2  2 1
1    2    3          3                                    3          3    2    1
1 2  2    3          3                                    3          3    2  2 1
1 2  2    33 333333 33                                    33 333333 33    2  2 1
1 2  2    3    7     3                                    3          3    2  2 1
1 2  2    3          3                                    3          3    2  2 1
1 2       333333333333    4444444444444444444444444444    333333333333       2 1
1                         4                          4                         1
1 2                       4                          4                       2 1
1 2  2                    4                          4                    2  2 1
1 2  2                    4                          4                    2  2 1
1 2  2                    4    5                5    4                    2  2 1
1 2                       4                          4                       2 1
1                         4                          4                         1
1 2                       4                          4                       2 1
1 2  2                    4        755555555                              2  2 1
1 2  2                    4                          4                    2  2 1
1 2  2                    4                          4                    2  2 1
1 2  2                    4                          4                    2  7 1
1 2  2                    4    5                5    4                    2  2 1
1 2  2                    4                          4                    2  2 1
1 2  2                    4                          4                    2  2 1
1 2  2                    4                          4                    2  2 1
1 2                       4                          4                       2 1
1                         4444444444444444444444444444                         1
1 2                                                                          2 1
1 2  2                                                                    2  2 1
1 2  2                                                                    2  2 1
1 2  2                                                                    2  2 1
1 2  2                                                                    2  2 1
1 2  2                                                                    2  2 1
1 2                                                                          2 1
1                                                                              1
1                                                                              1
1 2                                                                          2 1
1 2  2    6 6666666666666666666666666666666666666666666666666666666666    2  2 1
1 2  2    6    666          666                        6666666666    6    2  2 1
1 2  2    666 666666 66666666666 666666666666666666666 666666666666666    2  2 1
1 2  2    666 666666 666666666666666                                66    2  2 1
1 2  2    666 666666            66666666666666666666666666666666666666    2  2 1
1 2       666     66666666 6666666666666666666666666666666666666666666       2 1
1         666 666666666666 6666666666                               66         1
1 2       6   666666666666 666666666666666666 66666666666666666666 666       2 1
1 2  2    6 666666666666666666666666666666666 66666666666666666 66 666    2  2 1
1 2  2    6 666666666666666                                 666 66 666    2  2 1
1 2  2    6      666666666666666 66666666666666666666666666 666 66 666    2  2 1
1 2  2    66 6666666666666666666 666666        66           666 66 666    2  2 1
1 2  2    66                      66666 666666 66 66666 6666666 666666    2  2 1
1 2  2    6666666666666666666666 6666666666666 66                  666    2  2 1
1 2  2    66                                   66666666666666666676666    2  2 1
1 2  2    666666666666666666666666666666666666666666666666666666666666    2  2 1
1 2                                                                          2 1
1                                                                              1
1 2                                                                          2 1
1 2  2                                                                    2  2 1
1 2  2                                                                    2  2 1
1 2  2                                                                    2  2 1
1 2                                                                          2 1
1                                                                              1
1 2                                                                          2 1
1 2  2                                                                    2  2 1
1 2  2                                                                    2  2 1
1 2  2    333 3333333333333333333333333333333333333333333333333333 333    2  2 1
1 2  2    3   3   3   3   3                              3   3   3   3    2  2 1
1 7  2    3     3   3   3   3                          3 7 3   3     3    2    1
1 2  2    333333333333333333333333333333333333333333333333333333333333    2  2 1
1 2  2                                                                    2  2 1
1 2  22222222 22222222  22222222   2222222222   22222222  22222222 22222222  2 1
1 2                                                                          2 1
1 2                                                                          2 1
1 222222 22222 22222 2222222222 2222222  2222222 2222222222 22222 22222 222222 1
1                                                                              1
11111111111111111111111111111111111111111111111111111111111111111111111111111111